11 2
1111111111111
1000000000001
1000000000001
1000001000001
1000011100001
1000001000001
1000000000001
1000000000001
1111111111111